"market_level","hold_days","n_valid","tp_count","timed_count","avg_ret","median_ret","pct_pos"
"1","5","404","218","186","0.385376","0.33","0.9926"
"1","6","407","235","172","0.369639","0.33","0.9926"
"1","7","410","263","147","0.368214","0.33","0.9878"
"1","8","413","283","130","0.371785","0.33","0.9831"
"1","9","420","346","74","0.332522","0.33","0.9929"
"1","10","420","346","74","0.333286","0.33","0.9905"
"1","11","420","346","74","0.332857","0.33","0.9881"
"1","12","420","346","74","0.336091","0.33","0.9905"
"1","13","420","346","74","0.337489","0.33","0.9929"
"1","14","420","346","74","0.333518","0.33","0.981"
"1","15","420","346","74","0.327875","0.33","0.9738"
"1","16","420","346","74","0.324023","0.33","0.9667"
"1","17","420","346","74","0.326648","0.33","0.9786"
"1","18","420","346","74","0.329185","0.33","0.9786"
"1","19","420","346","74","0.326538","0.33","0.9714"
"1","20","420","346","74","0.325005","0.33","0.9571"
"2","5","232","115","117","0.421144","0.33","0.9871"
"2","6","234","130","104","0.383112","0.33","0.9829"
"2","7","235","140","95","0.381118","0.33","0.9745"
"2","8","238","158","80","0.378768","0.33","0.979"
"2","9","245","192","53","0.328665","0.33","0.9837"
"2","10","245","192","53","0.321497","0.33","0.9673"
"2","11","245","192","53","0.315147","0.33","0.9633"
"2","12","245","192","53","0.320145","0.33","0.9633"
"2","13","245","192","53","0.319866","0.33","0.9714"
"2","14","245","192","53","0.316885","0.33","0.9633"
"2","15","245","192","53","0.321327","0.33","0.9673"
"2","16","245","192","53","0.322518","0.33","0.9633"
"2","17","245","192","53","0.326347","0.33","0.9592"
"2","18","245","192","53","0.329442","0.33","0.9633"
"2","19","245","192","53","0.330774","0.33","0.9592"
"2","20","245","192","53","0.32986","0.33","0.9388"
"3","5","342","163","179","0.411412","0.33","0.9854"
"3","6","346","189","157","0.422098","0.33","0.9855"
"3","7","349","208","141","0.430378","0.33","0.9828"
"3","8","355","235","120","0.454131","0.33","0.9803"
"3","9","363","294","69","0.353187","0.33","0.9807"
"3","10","363","294","69","0.347155","0.33","0.9752"
"3","11","363","294","69","0.355621","0.33","0.978"
"3","12","363","294","69","0.355397","0.33","0.9752"
"3","13","363","294","69","0.356742","0.33","0.9752"
"3","14","363","294","69","0.346372","0.33","0.978"
"3","15","363","294","69","0.352892","0.33","0.9725"
"3","16","363","294","69","0.363908","0.33","0.978"
"3","17","363","294","69","0.355629","0.33","0.978"
"3","18","363","294","69","0.358631","0.33","0.9697"
"3","19","363","294","69","0.355356","0.33","0.9697"
"3","20","363","294","69","0.356298","0.33","0.9807"
"4","5","296","149","147","0.385595","0.33","0.9831"
"4","6","302","187","115","0.397895","0.33","0.9868"
"4","7","308","211","97","0.389796","0.33","0.9903"
"4","8","313","225","88","0.391082","0.33","0.9872"
"4","9","324","264","60","0.341602","0.33","0.9877"
"4","10","324","264","60","0.338001","0.33","0.9815"
"4","11","324","264","60","0.338189","0.33","0.9815"
"4","12","324","264","60","0.332913","0.33","0.9846"
"4","13","324","264","60","0.344842","0.33","0.9877"
"4","14","324","264","60","0.33784","0.33","0.9877"
"4","15","324","264","60","0.34575","0.33","0.9784"
"4","16","324","264","60","0.350854","0.33","0.9815"
"4","17","324","264","60","0.351358","0.33","0.9753"
"4","18","324","264","60","0.350557","0.33","0.9753"
"4","19","324","264","60","0.351708","0.33","0.9722"
"4","20","324","264","60","0.350966","0.33","0.9815"
"5","5","182","80","102","0.426398","0.33","0.967"
"5","6","184","89","95","0.465631","0.33","0.9837"
"5","7","187","105","82","26.060358","0.33","0.9733"
"5","8","189","122","67","26.755849","0.33","0.9735"
"5","9","196","160","36","0.337277","0.33","0.9745"
"5","10","196","160","36","0.343407","0.33","0.9745"
"5","11","196","160","36","0.373114","0.33","0.9643"
"5","12","196","160","36","0.356182","0.33","0.9643"
"5","13","196","160","36","0.401001","0.33","0.9643"
"5","14","196","160","36","0.391742","0.33","0.9643"
"5","15","196","160","36","0.387888","0.33","0.9745"
"5","16","196","160","36","0.407397","0.33","0.9847"
"5","17","196","160","36","0.375772","0.33","0.9643"
"5","18","196","160","36","0.408489","0.33","0.9796"
"5","19","195","160","35","0.411711","0.33","0.9641"
"5","20","195","160","35","0.41283","0.33","0.9641"
"6","5","286","131","155","0.426377","0.33","0.986"
"6","6","286","148","138","0.436244","0.33","0.993"
"6","7","292","172","120","0.408544","0.33","0.9829"
"6","8","293","185","108","0.417332","0.33","0.9932"
"6","9","302","242","60","0.350032","0.33","0.9868"
"6","10","302","242","60","0.356803","0.33","0.9834"
"6","11","302","242","60","0.350629","0.33","0.9868"
"6","12","301","242","59","0.345631","0.33","0.9801"
"6","13","301","242","59","0.348792","0.33","0.9801"
"6","14","301","242","59","0.355758","0.33","0.99"
"6","15","301","242","59","0.347515","0.33","0.9834"
"6","16","301","242","59","0.343581","0.33","0.9701"
"6","17","301","242","59","0.3453","0.33","0.9635"
"6","18","301","242","59","0.347269","0.33","0.9601"
"6","19","301","242","59","0.354031","0.33","0.9601"
"6","20","301","242","59","0.354455","0.33","0.9601"
"7","5","559","271","288","0.631482","0.33","0.9946"
"7","6","563","299","264","0.817746","0.33","0.9947"
"7","7","571","336","235","0.695955","0.33","0.9965"
"7","8","584","378","206","0.706159","0.33","0.9966"
"7","9","601","503","98","0.384178","0.33","0.9967"
"7","10","601","503","98","0.39467","0.33","0.9967"
"7","11","601","503","98","0.398999","0.33","0.9967"
"7","12","601","503","98","0.402541","0.33","0.995"
"7","13","600","503","97","0.385096","0.33","0.99"
"7","14","600","503","97","0.415448","0.33","0.9933"
"7","15","601","503","98","0.426946","0.33","0.9917"
"7","16","601","503","98","0.443337","0.33","0.9933"
"7","17","601","503","98","0.43569","0.33","0.995"
"7","18","601","503","98","0.450141","0.33","0.9983"
"7","19","601","503","98","0.425386","0.33","0.9917"
"7","20","600","503","97","0.416935","0.33","0.9933"
"8","5","499","218","281","0.47128","0.33","0.998"
"8","6","505","254","251","0.462529","0.33","0.9941"
"8","7","513","289","224","0.483272","0.33","0.9883"
"8","8","523","325","198","0.430279","0.33","0.9847"
"8","9","543","439","104","0.344968","0.33","0.9779"
"8","10","543","439","104","0.348671","0.33","0.9797"
"8","11","543","439","104","0.351419","0.33","0.9742"
"8","12","543","439","104","0.346612","0.33","0.9742"
"8","13","543","439","104","0.351505","0.33","0.9724"
"8","14","543","439","104","0.357119","0.33","0.9705"
"8","15","543","439","104","0.363667","0.33","0.9761"
"8","16","543","439","104","0.368029","0.33","0.9669"
"8","17","543","439","104","0.371909","0.33","0.9687"
"8","18","543","439","104","0.376457","0.33","0.9687"
"8","19","543","439","104","0.379596","0.33","0.9687"
"8","20","543","439","104","0.383114","0.33","0.965"
"9","5","602","280","322","0.431026","0.33","0.9917"
"9","6","610","323","287","0.443677","0.33","0.9902"
"9","7","615","367","248","0.440871","0.33","0.9886"
"9","8","618","396","222","0.436138","0.33","0.9854"
"9","9","637","515","122","0.349175","0.33","0.9859"
"9","10","637","515","122","0.351944","0.33","0.978"
"9","11","637","515","122","0.353657","0.33","0.9827"
"9","12","637","515","122","0.352284","0.33","0.9812"
"9","13","637","515","122","0.350384","0.33","0.978"
"9","14","637","515","122","0.350728","0.33","0.9717"
"9","15","637","515","122","0.353547","0.33","0.9702"
"9","16","637","515","122","0.348258","0.33","0.9639"
"9","17","637","515","122","0.353301","0.33","0.9639"
"9","18","637","515","122","0.354568","0.33","0.9639"
"9","19","637","515","122","0.352807","0.33","0.9623"
"9","20","638","515","123","0.356622","0.33","0.9608"
